# Jugadores
spawn white 8 5
spawn red 12 7

# Power-ups

# Enemigos
enemy dragon 1 2
enemy dragon 1 17
enemy dragon 11 2
enemy dragon 11 17
enemy dragon 5 4
enemy dragon 5 14

12 3 4 2 4 2 4 2 4 2 4 2 4 2 4 2 4 2 4 2 13
12 0 6 7 7 7 7 7 7 7 8 7 7 7 7 7 7 7 7 0 13
12 1 9 8 10 8 10 8 10 8 10 8 10 8 10 8 10 8 9 1 13
12 0 9 7 10 7 10 10 10 10 10 10 10 10 10 7 10 7 10 0 13
12 1 10 8 9 8 10 8 9 8 9 8 9 8 10 8 9 8 10 1 13
12 0 9 10 10 10 10 7 10 7 10 7 10 7 10 10 10 10 10 0 13
12 1 9 8 9 8 10 8 9 8 10 8 9 8 10 8 9 8 9 1 13
12 0 9 10 10 10 10 7 10 7 10 7 10 7 10 10 10 10 10 0 13
12 1 10 8 9 8 10 8 9 8 9 8 9 8 10 8 9 8 10 1 13
12 0 9 7 10 7 10 10 10 10 10 10 10 10 10 7 10 7 10 0 13
12 1 9 8 10 8 10 8 10 8 10 8 10 8 10 8 10 8 9 1 13
12 0 9 7 10 7 10 7 10 7 8 7 10 7 10 7 10 7 10 0 13
12 1 4 2 4 2 4 2 4 2 4 2 4 2 4 2 4 2 4 5 13