# Jugadores con coordenadas x y (columna, fila)
spawn white 8 5
spawn red 12 7

# Power-ups con coordenadas x y (columna, fila)

# Enemigos con coordenadas x y (columna, fila)
enemy fantasma 2 3
enemy fantasma 18 3
enemy fantasma 2 9
enemy fantasma 18 9
enemy babosa 10 1
enemy babosa 10 11

12 3 4 2 4 2 4 2 4 2 4 2 4 2 4 2 4 2 4 2 13
12 0 30 30 30 8 30 30 30 20 30 30 30 20 30 30 30 30 30 0 13
12 1 30 8 30 8 8 8 30 8 30 8 8 8 20 8 30 8 30 1 13
12 0 30 30 30 20 30 20 30 30 30 20 30 30 30 8 20 30 30 0 13
12 1 8 8 30 8 30 8 8 8 30 8 8 8 30 8 30 8 8 1 13
12 0 30 30 20 30 30 30 30 20 30 20 30 30 30 30 20 30 30 0 13
12 1 8 8 30 8 30 8 9 8 20 8 30 8 30 8 9 8 8 1 13
12 0 30 30 20 30 30 30 30 20 30 20 30 30 30 30 20 30 30 0 13
12 1 8 8 30 8 30 8 8 8 9 8 8 8 30 8 9 8 8 1 13
12 0 30 30 20 8 30 30 30 20 30 30 30 20 30 20 30 30 30 0 13
12 1 30 8 30 8 30 8 8 8 30 8 30 8 8 8 30 8 9 1 13
12 0 30 30 30 30 30 20 30 30 30 20 30 30 30 8 30 30 30 0 13
12 1 4 2 4 2 4 2 4 2 4 2 4 2 4 2 4 2 4 5 13