# Jugadores con coordenadas x y (columna, fila)
spawn white 8 5
spawn red 12 7

# Power-ups con coordenadas x y (columna, fila)
powerup flame 10 3
powerup flame 2 6
powerup flame 18 6
powerup flame 10 9
powerup bomba 14 1
powerup bomba 6 11
powerup velocidad 6 1
powerup velocidad 10 7
powerup velocidad 14 11

# Enemigos con coordenadas x y (columna, fila)
enemy sol 10 5

12 1 4 3 14 3 4 3 14 27 26 28 14 3 4 3 14 3 4 2 13
12 15 6 7 7 7 7 7 7 7 7 7 7 7 7 7 7 7 7 36 13
12 22 9 8 10 8 10 8 10 8 10 8 10 8 10 8 10 8 9 5 13
12 18 9 7 10 7 10 10 10 10 10 10 10 10 10 7 10 7 10 35 13
12 22 10 8 9 8 10 8 9 8 9 8 9 8 10 8 9 8 10 5 13
12 24 9 10 10 10 10 7 10 7 10 7 10 7 10 10 10 10 10 38 13
12 23 9 8 9 8 10 8 9 8 10 8 9 8 10 8 9 8 9 37 13
12 25 9 10 10 10 10 7 10 7 10 7 10 7 10 10 10 10 10 39 13
12 22 10 8 9 8 10 8 9 8 9 8 9 8 10 8 9 8 10 5 13
12 18 9 7 10 7 10 10 10 10 10 10 10 10 10 7 10 7 10 35 13
12 22 9 8 10 8 10 8 10 8 10 8 10 8 10 8 10 8 9 5 13
12 15 9 7 10 7 10 7 10 7 10 7 10 7 10 7 10 7 10 36 13
12 16 19 29 31 29 19 29 31 33 32 34 31 29 19 29 31 29 19 17 13