# Jugadores con coordenadas x y (columna, fila)
spawn white 8 5
spawn red 12 7

# Power-ups con coordenadas x y (columna, fila)
powerup flame 18 1
powerup flame 2 11
powerup flame 10 3
powerup flame 10 9
powerup bomba 2 1
powerup bomba 18 11
powerup bomba 6 6
powerup bomba 14 6
powerup velocidad 10 1
powerup velocidad 10 11

# Enemigos con coordenadas x y (columna, fila)
enemy king 10 6
enemy dronazul 6 3
enemy dronamarillo 6 9
enemy dronverde 14 3
enemy dronrosa 14 9

12 14 15 18 15 18 15 18 15 18 15 18 15 18 15 18 15 18 15 16 13
12 1 6 7 7 7 7 7 7 7 7 7 7 7 7 7 7 7 7 1 13
12 4 9 8 10 8 10 8 10 8 10 8 10 8 10 8 10 8 9 4 13
12 1 9 7 10 7 10 10 10 10 10 10 10 10 10 7 10 7 10 1 13
12 4 10 8 9 8 10 8 9 8 9 8 9 8 10 8 9 8 10 4 13
12 1 9 10 10 10 10 7 10 7 10 7 10 7 10 10 10 10 10 1 13
12 4 9 8 9 8 10 8 9 8 10 8 9 8 10 8 9 8 9 4 13
12 1 9 10 10 10 10 7 10 7 10 7 10 7 10 10 10 10 10 1 13
12 4 10 8 9 8 10 8 9 8 9 8 9 8 10 8 9 8 10 4 13
12 1 9 7 10 7 10 10 10 10 10 10 10 10 10 7 10 7 10 1 13
12 4 9 8 10 8 10 8 10 8 10 8 10 8 10 8 10 8 9 4 13
12 1 9 7 10 7 10 7 10 7 10 7 10 7 10 7 10 7 10 1 13
12 2 15 18 15 18 15 18 15 18 15 18 15 18 15 18 15 18 15 5 13