0 1 0 1 0 1 0 1 0 1 0 1 0 1 0 1 0 1 0
1 2 3 3 3 3 3 3 3 3 3 3 3 3 3 3 3 3 1
0 5 4 5 4 5 4 5 4 5 4 5 4 5 4 5 4 5 0
1 5 3 6 3 6 3 6 3 6 3 6 3 6 3 6 3 6 1
0 5 4 5 4 5 4 5 4 5 4 5 4 5 4 5 4 5 0
1 5 3 6 3 6 3 6 3 6 3 6 3 6 3 6 3 6 1
0 5 4 5 4 5 4 5 4 5 4 5 4 5 4 5 4 5 0
1 5 3 6 3 6 3 6 3 6 3 6 3 6 3 6 3 6 1
0 5 4 5 4 5 4 5 4 5 4 5 4 5 4 5 4 5 0
1 5 3 6 3 6 3 6 3 6 3 6 3 6 3 6 3 6 1
0 5 4 5 4 5 4 5 4 5 4 5 4 5 4 5 4 5 0
1 5 3 6 3 6 3 6 3 6 3 6 3 6 3 6 3 6 1
0 1 0 1 0 1 0 1 0 1 0 1 0 1 0 1 0 1 0