# Jugadores con coordenadas x y (columna, fila)
spawn white 8 5
spawn red 12 7

# Power-ups con coordenadas x y (columna, fila)

# Enemigos con coordenadas x y (columna, fila)
enemy 1 2 1
enemy 2 18 1
enemy 3 2 11
enemy 4 18 11
enemy 5 9 9
enemy 6 11 3
enemy 7 2 6
enemy 8 18 6
enemy 9 7 1
enemy 10 13 11
enemy 11 6 6
enemy 12 14 6

12 0 1 2 3 0 1 2 4 2 5 51 44 1 0 1 0 3 2 1 13
12 14 30 30 30 20 30 30 30 30 30 30 30 30 30 20 30 30 30 34 13
12 16 20 8 30 8 30 8 20 8 30 8 20 8 30 8 30 8 20 36 13
12 17 8 30 30 8 30 30 20 30 30 30 20 30 30 8 30 30 8 37 13
12 19 30 8 30 8 20 8 30 8 20 8 30 8 20 8 30 8 30 39 13
12 18 30 20 30 30 30 20 30 30 30 30 30 20 30 30 30 20 30 38 13
12 15 30 8 30 8 30 8 30 8 30 8 30 8 30 8 30 8 30 35 13
12 17 30 20 30 30 30 20 30 30 30 30 30 20 30 30 30 20 30 37 13
12 19 30 8 30 8 20 8 30 8 20 8 30 8 20 8 30 8 30 39 13
12 18 8 30 30 8 30 30 20 30 30 30 20 30 30 8 30 30 8 38 13
12 15 20 8 30 8 30 8 20 8 30 8 20 8 30 8 30 8 20 35 13
12 14 30 30 30 20 30 30 30 30 30 30 30 30 30 20 30 30 30 34 13
12 40 22 23 24 25 26 22 27 26 28 27 25 27 26 25 24 23 22 40 13