spawn white 8 5
spawn red 12 7

12 3 4 2 4 2 4 2 4 2 4 2 4 2 4 2 4 2 4 2 13
12 0 6 7 7 7 7 7 7 7 8 7 7 7 7 7 7 7 7 0 13
12 1 9 8 20 8 20 8 20 8 20 8 20 8 20 8 20 8 9 1 13
12 0 9 20 10 7 10 20 10 20 10 20 10 20 10 7 10 20 10 0 13
12 1 9 8 9 8 20 8 9 8 9 8 9 8 20 8 9 8 9 1 13
12 0 9 20 10 20 10 7 10 7 10 7 10 7 10 20 10 20 10 0 13
12 1 9 8 9 8 20 8 9 8 20 8 9 8 20 8 9 8 9 1 13
12 0 9 20 10 20 10 7 10 7 10 7 10 7 10 20 10 20 10 0 13
12 1 9 8 9 8 20 8 9 8 9 8 9 8 20 8 9 8 9 1 13
12 0 9 20 10 7 10 20 10 20 10 20 10 20 10 7 10 20 10 0 13
12 1 9 8 20 8 20 8 20 8 20 8 20 8 20 8 20 8 9 1 13
12 0 9 7 10 7 10 7 10 7 8 7 10 7 10 7 10 7 10 0 13
12 1 4 2 4 2 4 2 4 2 4 2 4 2 4 2 4 2 4 5 13