# Jugadores con coordenadas x y (columna, fila)
spawn white 8 5
spawn red 12 7

# Power-ups con coordenadas x y (columna, fila)

# Enemigos con coordenadas x y (columna, fila)
enemy dragon 2 1
enemy dragon 18 1
enemy dragon 2 11
enemy dragon 18 11
enemy dragon 9 9
enemy dragon 11 3

12 3 4 2 4 2 4 2 4 2 4 2 4 2 4 2 4 2 4 2 13
12 0 30 30 30 20 30 30 30 30 30 30 30 30 30 20 30 30 30 0 13
12 1 20 8 30 8 30 8 20 8 30 8 20 8 30 8 30 8 20 1 13
12 0 8 30 30 8 30 30 20 30 30 30 20 30 30 8 30 30 8 0 13
12 1 30 8 30 8 20 8 30 8 20 8 30 8 20 8 30 8 30 1 13
12 0 30 20 30 30 30 20 30 30 30 30 30 20 30 30 30 20 30 0 13
12 1 30 8 30 8 30 8 30 8 30 8 30 8 30 8 30 8 30 1 13
12 0 30 20 30 30 30 20 30 30 30 30 30 20 30 30 30 20 30 0 13
12 1 30 8 30 8 20 8 30 8 20 8 30 8 20 8 30 8 30 1 13
12 0 8 30 30 8 30 30 20 30 30 30 20 30 30 8 30 30 8 0 13
12 1 20 8 30 8 30 8 20 8 30 8 20 8 30 8 30 8 20 1 13
12 0 30 30 30 20 30 30 30 30 30 30 30 30 30 20 30 30 30 0 13
12 3 4 2 4 2 4 2 4 2 4 2 4 2 4 2 4 2 4 2 13