spawn white 8 5
spawn red 12 7

12 3 4 2 4 2 4 2 4 2 4 2 4 2 4 2 4 2 4 2 13
12 0 6 7 20 7 20 7 20 7 20 7 20 7 20 7 20 7 7 0 13
12 1 7 8 7 8 7 8 7 8 7 8 7 8 7 8 7 8 7 1 13
12 0 20 7 20 7 20 7 10 7 10 7 10 7 20 7 20 7 20 0 13
12 1 7 8 7 8 7 8 7 8 7 8 7 8 7 8 7 8 7 1 13
12 0 20 7 20 7 10 7 10 7 10 7 10 7 10 7 20 7 20 0 13
12 1 7 8 7 8 7 8 7 7 7 8 7 8 7 8 7 8 7 1 13
12 0 20 7 20 7 10 7 10 7 10 7 10 7 10 7 20 7 20 0 13
12 1 7 8 7 8 7 8 7 8 7 8 7 8 7 8 7 8 7 1 13
12 0 20 7 20 7 20 7 10 7 10 7 10 7 20 7 20 7 20 0 13
12 1 7 8 7 8 7 8 7 8 7 8 7 8 7 8 7 8 7 1 13
12 0 7 7 20 7 20 7 20 7 20 7 20 7 20 7 20 7 7 0 13
12 1 4 2 4 2 4 2 4 2 4 2 4 2 4 2 4 2 4 5 13