# Jugadores con coordenadas x y (columna, fila)
spawn white 8 5
spawn red 12 7

# Power-ups con coordenadas x y (columna, fila)

# Enemigos con coordenadas x y (columna, fila)
enemy fantasma 2 3
enemy fantasma 18 3
enemy fantasma 2 9
enemy fantasma 18 9
enemy babosa 10 1
enemy babosa 10 11

12 3 4 2 4 2 4 2 4 2 4 2 4 2 4 2 4 2 4 2 13
12 0 6 7 7 7 7 7 7 7 7 7 7 7 7 7 7 7 7 0 13
12 1 9 8 10 8 10 8 10 8 10 8 10 8 10 8 10 8 9 1 13
12 0 9 7 10 7 10 10 10 10 10 10 10 10 10 7 10 7 10 0 13
12 1 10 8 9 8 10 8 9 8 9 8 9 8 10 8 9 8 10 1 13
12 0 9 10 10 10 10 7 10 7 10 7 10 7 10 10 10 10 10 0 13
12 1 9 8 9 8 10 8 9 8 10 8 9 8 10 8 9 8 9 1 13
12 0 9 10 10 10 10 7 10 7 10 7 10 7 10 10 10 10 10 0 13
12 1 10 8 9 8 10 8 9 8 9 8 9 8 10 8 9 8 10 1 13
12 0 9 7 10 7 10 10 10 10 10 10 10 10 10 7 10 7 10 0 13
12 1 9 8 10 8 10 8 10 8 10 8 10 8 10 8 10 8 9 1 13
12 0 9 7 10 7 10 7 10 7 10 7 10 7 10 7 10 7 10 0 13
12 1 4 2 4 2 4 2 4 2 4 2 4 2 4 2 4 2 4 5 13