# Jugadores con coordenadas x y (columna, fila)
spawn white 8 5
spawn red 12 7

# Power-ups con coordenadas x y (columna, fila)

# Enemigos con coordenadas x y (columna, fila)
enemy 1 2 3
enemy 2 18 3
enemy 3 2 9
enemy 4 18 9
enemy 5 10 1
enemy 6 10 11
enemy 7 6 1
enemy 8 14 1
enemy 9 6 11
enemy 10 14 11
enemy 11 2 5
enemy 12 18 7

12 1 4 3 14 3 4 3 14 27 26 28 14 3 4 3 14 3 4 2 13
12 15 30 30 30 8 30 30 30 20 30 30 30 20 30 30 30 30 30 36 13
12 22 30 8 30 8 8 8 30 8 30 8 8 8 20 8 30 8 30 5 13
12 18 30 30 30 20 30 20 30 30 30 20 30 30 30 8 20 30 30 35 13
12 22 8 8 30 8 30 8 8 8 30 8 8 8 30 8 30 8 8 5 13
12 24 30 30 20 30 30 30 30 20 30 20 30 30 30 30 20 30 30 38 13
12 23 8 8 30 8 30 8 9 8 20 8 30 8 30 8 9 8 8 37 13
12 25 30 30 20 30 30 30 30 20 30 20 30 30 30 30 20 30 30 39 13
12 22 8 8 30 8 30 8 8 8 9 8 8 8 30 8 9 8 8 5 13
12 18 30 30 20 8 30 30 30 20 30 30 30 20 30 20 30 30 30 35 13
12 22 30 8 30 8 30 8 8 8 30 8 30 8 8 8 30 8 9 5 13
12 15 30 30 30 30 30 20 30 30 30 20 30 30 30 8 30 30 30 36 13
12 16 19 29 31 29 19 29 31 33 32 34 31 29 19 29 31 29 19 17 13