# VS - 4 Bomberman (blanco/rojo/azul/amarillo)
# Spawns con coordenadas x y (columna, fila)
spawn 0 2 1
spawn 1 18 1
spawn 2 2 11
spawn 3 18 11

# Power-ups: de momento no se definen en VS
# Enemigos: VS sin enemigos

12 3 4 2 4 2 4 2 4 2 4 2 4 2 4 2 4 2 4 2 13
12 0 6 7 7 7 7 7 7 7 8 7 7 7 7 7 7 7 7 0 13
12 1 9 8 20 8 20 8 20 8 20 8 20 8 20 8 20 8 9 1 13
12 0 9 7 10 7 10 20 10 20 10 20 10 20 10 7 10 7 10 0 13
12 1 20 8 9 8 20 8 9 8 9 8 9 8 20 8 9 8 20 1 13
12 0 9 20 10 20 10 7 10 7 10 7 10 7 10 20 10 20 10 0 13
12 1 9 8 9 8 20 8 9 8 20 8 9 8 20 8 9 8 9 1 13
12 0 9 20 10 20 10 7 10 7 10 7 10 7 10 20 10 20 10 0 13
12 1 20 8 9 8 20 8 9 8 9 8 9 8 20 8 9 8 20 1 13
12 0 9 7 10 7 10 20 10 20 10 20 10 20 10 7 10 7 10 0 13
12 1 9 8 20 8 20 8 20 8 20 8 20 8 20 8 20 8 9 1 13
12 0 9 7 10 7 10 7 10 7 8 7 10 7 10 7 10 7 10 0 13
12 1 4 2 4 2 4 2 4 2 4 2 4 2 4 2 4 2 4 5 13
